bin/Images/Textures-16.png
16 16
10
6 18
3 18
12 3
11 18
15 21
12 14
0 5
0 12
0 13
24 31
50 29
3 3 3 3 3 1 2 1 3 3 3 3 3 3 3 3 3 3 3 3 1 2 1 3 3 3 3 3 3 3 3 3 3 3 3 3 3 3 3 3 3 3 3 3 3 3 3 3 3 3
3 0 0 0 0 1 2 1 0 0 0 0 0 0 0 0 0 0 0 0 1 2 1 0 0 0 0 0 0 0 0 0 0 0 0 0 0 0 0 0 0 0 0 0 0 0 0 0 0 3
3 0 0 0 0 1 2 1 0 0 0 0 0 0 0 0 0 0 0 0 1 2 1 0 0 0 0 0 0 0 0 0 0 0 1 1 1 1 1 0 0 0 0 0 0 0 0 0 0 3
3 0 0 0 0 1 2 1 0 0 0 0 0 0 0 0 0 0 0 0 1 2 1 0 0 0 0 0 0 0 0 0 0 0 1 2 2 2 1 0 0 0 0 0 1 1 1 1 1 1
3 0 1 1 1 1 2 1 1 1 1 1 1 1 1 1 1 1 1 1 1 2 1 1 1 1 1 1 1 1 0 0 0 0 1 2 2 2 1 0 0 0 0 0 1 2 2 2 2 2
3 0 1 2 2 2 2 2 2 2 2 2 2 2 2 2 2 2 2 2 2 2 2 2 2 2 2 2 2 1 1 1 1 1 1 9 9 9 1 1 1 1 1 1 1 2 1 1 1 1
3 0 1 2 1 1 1 1 1 1 2 1 1 1 1 1 1 2 1 1 1 1 1 1 1 1 1 1 2 2 2 2 2 2 2 2 2 2 2 2 2 2 2 2 2 2 1 0 0 3
3 0 1 2 1 0 0 0 0 1 2 1 0 0 0 0 1 2 1 0 0 0 0 0 0 0 0 1 2 1 1 1 1 1 1 1 1 1 1 1 1 2 1 1 1 2 1 0 0 3
3 0 1 2 1 0 1 1 1 1 2 1 1 1 1 0 1 2 1 1 1 1 1 1 0 0 0 1 2 1 0 0 0 0 0 0 0 0 0 0 1 2 1 0 1 2 1 0 0 3
3 0 1 2 1 0 1 2 2 2 2 2 2 2 1 0 1 2 2 4 4 6 2 1 0 0 0 1 2 1 0 1 1 1 1 1 1 1 0 0 1 2 1 0 1 2 1 1 0 3
3 0 1 2 1 0 1 6 4 6 6 6 4 6 1 0 1 2 2 6 4 6 2 1 0 0 0 1 2 1 0 1 2 7 7 7 2 1 0 0 1 2 1 0 1 2 2 1 0 3
1 1 1 2 1 0 1 6 4 6 6 6 4 6 1 0 1 2 2 6 4 4 2 1 0 0 0 1 2 1 0 1 2 4 4 4 2 1 0 0 1 2 1 0 1 6 2 1 0 3
2 2 2 2 1 0 1 6 4 6 6 6 4 6 1 0 1 1 1 1 1 1 1 1 0 0 0 1 2 1 0 1 2 7 7 7 2 1 0 0 1 2 1 0 1 2 2 1 0 3
1 1 1 2 1 0 1 2 2 2 2 2 2 2 1 0 0 0 0 0 0 0 0 0 0 0 0 1 2 1 0 1 1 1 1 1 2 1 0 0 1 2 1 0 1 1 1 1 0 3
3 0 1 2 1 0 1 1 1 1 2 1 1 1 1 0 0 0 0 0 0 0 0 0 0 0 0 1 2 1 0 0 0 0 0 1 2 1 0 0 1 2 1 0 0 0 0 0 0 3
3 0 1 2 1 0 0 0 0 1 2 1 0 0 0 0 1 1 1 1 1 1 1 1 1 1 1 1 2 1 1 1 1 1 1 1 2 1 1 1 1 2 1 1 1 1 1 1 1 1
3 0 1 2 1 1 1 1 0 1 2 1 0 1 1 1 1 2 2 2 2 2 2 2 2 2 2 2 2 2 2 2 2 2 2 2 2 2 2 2 2 2 2 2 2 2 2 2 2 2
3 0 1 2 1 1 5 1 0 1 2 1 0 1 5 1 1 2 1 1 1 1 1 1 1 1 1 1 2 1 1 1 1 1 1 1 2 1 1 1 1 1 1 1 1 1 2 1 1 1
3 0 1 2 2 2 2 1 0 1 2 1 0 1 2 2 2 2 1 0 0 0 0 0 0 0 0 1 2 1 0 0 0 0 0 1 2 1 0 0 0 0 0 0 0 1 8 1 0 3
3 0 1 2 1 1 1 1 0 1 2 1 0 1 1 1 1 2 1 0 0 1 1 1 1 1 0 1 2 1 0 1 1 1 1 1 2 1 1 1 1 1 1 1 0 1 8 1 0 3
3 0 1 2 1 0 0 0 0 1 2 1 0 0 0 0 1 2 1 0 0 1 2 4 2 1 1 1 2 1 0 1 2 2 2 2 2 2 2 2 2 2 2 1 0 1 8 1 0 3
3 0 1 2 1 1 1 1 1 1 2 1 1 1 1 1 1 2 1 0 0 1 2 7 2 2 2 2 2 1 0 1 7 7 7 7 7 7 7 7 7 7 7 1 0 1 8 1 0 3
3 0 1 2 2 2 2 2 2 2 2 2 2 2 2 2 2 2 1 0 0 1 1 1 1 1 1 1 2 1 0 1 7 7 7 7 7 7 7 7 7 7 7 1 0 1 8 1 0 3
3 0 1 1 1 1 1 1 1 1 2 1 1 1 1 1 1 2 1 0 0 0 0 0 0 0 0 1 2 1 0 1 7 7 7 7 7 7 7 7 7 7 7 1 0 1 8 1 0 3
3 0 0 0 0 0 0 0 0 1 2 1 0 0 0 0 1 2 1 1 1 1 1 1 1 1 1 1 2 1 1 1 7 7 7 7 7 7 7 7 7 7 7 1 0 1 8 1 0 3
3 0 0 0 0 0 0 0 0 1 2 1 0 0 0 0 1 2 2 2 2 2 2 2 2 2 2 2 2 2 2 2 7 7 7 7 7 7 7 7 7 2 2 1 0 1 2 1 0 3
3 0 0 0 0 0 0 0 0 1 2 1 0 0 0 0 1 1 1 1 1 1 1 2 1 1 1 1 1 1 1 1 1 1 1 1 1 1 1 1 1 1 2 1 0 1 1 1 0 3
3 0 0 0 0 0 0 0 0 1 2 1 0 0 0 0 0 0 0 0 0 0 1 2 1 0 0 0 0 0 0 0 0 0 0 0 0 0 0 0 0 1 2 1 0 0 0 0 0 3
3 3 3 3 3 3 3 3 3 1 2 1 3 3 3 3 3 3 3 3 3 3 1 2 1 3 3 3 3 3 3 3 3 3 3 3 3 3 3 3 3 1 2 1 3 3 3 3 3 3

